id;cod_dep;departamento;cod_mun;municipio;vaginales;cesareas;partos_atendidos_personal_salud;tot_gral;cobertura
1;1;CHUQUISACA;10101;SUCRE                         ;4055;2755;40;6850;0,674774499
2;1;CHUQUISACA;10102;YOTALA                        ;97;3;8;108;0,326889477
3;1;CHUQUISACA;10103;POROMA                        ;86;0;149;235;0,37937905
4;1;CHUQUISACA;10201;AZURDUY                       ;72;0;83;155;0,533166023
5;1;CHUQUISACA;10202;TARVITA                       ;175;9;54;238;0,553012126
6;1;CHUQUISACA;10301;ZUDAÑEZ                       ;85;0;24;109;0,573970158
7;1;CHUQUISACA;10302;PRESTO                        ;48;0;101;149;0,578846001
8;1;CHUQUISACA;10303;MOJOCOYA                      ;75;0;25;100;0,516405017
9;1;CHUQUISACA;10304;ICLA                          ;66;0;56;122;0,459098348
10;1;CHUQUISACA;10401;PADILLA                       ;153;111;9;273;0,902108115
11;1;CHUQUISACA;10402;TOMINA                        ;106;0;14;120;0,446556159
12;1;CHUQUISACA;10403;SOPACHUY                      ;70;0;23;93;0,430591179
13;1;CHUQUISACA;10404;ALCALA                        ;42;0;2;44;0,401595537
14;1;CHUQUISACA;10405;EL VILLAR                     ;46;0;7;53;0,512509466
15;1;CHUQUISACA;10501;MONTEAGUDO                    ;366;215;7;588;0,825799991
16;1;CHUQUISACA;10502;HUACARETA                     ;106;0;15;121;0,488883672
17;1;CHUQUISACA;10601;TARABUCO                      ;147;40;76;263;0,527195391
18;1;CHUQUISACA;10602;YAMPARAEZ                     ;68;0;15;83;0,385807164
19;1;CHUQUISACA;10701;CAMARGO                       ;235;100;29;364;0,949240652
20;1;CHUQUISACA;10702;SAN LUCAS                     ;321;13;208;542;0,608241352
21;1;CHUQUISACA;10703;INCAHUASI                     ;72;0;103;175;0,439110492
22;1;CHUQUISACA;10704;VILLA CHARCAS                 ;164;1;111;276;0,915448684
23;1;CHUQUISACA;10801;VILLA SERRANO                 ;93;0;29;122;0,411439998
24;1;CHUQUISACA;10901;CAMATAQUI (C. VILLA ABECIA)   ;33;0;4;37;0,44674575
25;1;CHUQUISACA;10902;CULPINA                       ;169;0;87;256;0,576236475
26;1;CHUQUISACA;10903;LAS CARRERAS                  ;42;0;5;47;0,495915563
27;1;CHUQUISACA;11001;VILLA VACA GUZMAN (MUYUPAMPA) ;72;0;30;102;0,346996494
28;1;CHUQUISACA;11002;HUACAYA (VILLA DE HUACAYA)    ;38;0;21;59;0,89433983
29;1;CHUQUISACA;11003;MACHARETI                     ;60;0;6;66;0,28201927
30;2;LA PAZ ;20101;LA PAZ                        ;11888;8669;9;20566;0,838138533
31;2;LA PAZ ;20102;PALCA                         ;65;0;65;130;0,305349882
32;2;LA PAZ ;20103;MECAPACA                      ;31;0;43;74;0,20422054
33;2;LA PAZ ;20104;ACHOCALLA                     ;67;0;54;121;0,26169113
34;2;LA PAZ ;20105;EL ALTO                       ;11969;3541;97;15607;0,566533581
35;2;LA PAZ ;20201;ACHACACHI                     ;305;33;159;497;0,414754732
36;2;LA PAZ ;20202;ANCORAIMES                    ;36;0;127;163;0,546980724
37;2;LA PAZ ;20203;CHUA COCANI                   ;0;0;38;38;0,320098487
38;2;LA PAZ ;20204;HUARINA                       ;22;0;24;46;0,235652167
39;2;LA PAZ ;20205;SANTIAGO DE HUATA             ;22;0;58;80;0,476784931
40;2;LA PAZ ;20206;HUATAJATA                     ;14;0;5;19;0,19987545
41;2;LA PAZ ;20301;CORO CORO                     ;24;0;73;97;0,416265925
42;2;LA PAZ ;20302;CAQUIAVIRI                    ;22;0;83;105;0,420960538
43;2;LA PAZ ;20303;CALACOTO                      ;6;0;41;47;0,253026697
44;2;LA PAZ ;20304;COMANCHE                      ;2;0;25;27;0,389356451
45;2;LA PAZ ;20305;CHARAÑA                       ;2;0;13;15;0,269910251
46;2;LA PAZ ;20306;WALDO BALLIVIAN               ;1;0;26;27;0,757763296
47;2;LA PAZ ;20307;NAZACARA DE PACAJES           ;2;0;8;10;1,122580317
48;2;LA PAZ ;20308;SANTIAGO DE CALLAPA           ;19;0;29;48;0,308918519
49;2;LA PAZ ;20401;PUERTO ACOSTA                 ;34;0;94;128;0,408020183
50;2;LA PAZ ;20402;MOCOMOCO                      ;23;0;132;155;0,562627148
51;2;LA PAZ ;20403;PUERTO CARABUCO               ;27;0;124;151;0,438421764
52;2;LA PAZ ;20404;HUMANATA                      ;10;0;54;64;0,553741677
53;2;LA PAZ ;20405;ESCOMA                        ;63;13;17;93;0,709617779
54;2;LA PAZ ;20501;CHUMA                         ;29;0;77;106;0,314607259
55;2;LA PAZ ;20502;AYATA                         ;20;0;95;115;0,464536209
56;2;LA PAZ ;20503;AUCAPATA                      ;1;0;64;65;0,863737425
57;2;LA PAZ ;20601;SORATA                        ;96;0;72;168;0,356994925
58;2;LA PAZ ;20602;GUANAY                        ;154;0;45;199;0,834947786
59;2;LA PAZ ;20603;TACACOMA                      ;64;0;14;78;0,660567984
60;2;LA PAZ ;20604;QUIABAYA                      ;36;0;4;40;0,688657419
61;2;LA PAZ ;20605;COMBAYA                       ;5;0;30;35;0,662386255
62;2;LA PAZ ;20606;TIPUANI                       ;145;0;0;145;1,133995825
63;2;LA PAZ ;20607;MAPIRI                        ;257;0;9;266;1,335611888
64;2;LA PAZ ;20608;TEOPONTE                      ;139;0;39;178;1,211076831
65;2;LA PAZ ;20701;APOLO                         ;160;0;73;233;0,890903633
66;2;LA PAZ ;20702;PELECHUCO                     ;17;0;62;79;0,790792982
67;2;LA PAZ ;20801;VIACHA                        ;553;55;67;675;0,565418117
68;2;LA PAZ ;20802;GUAQUI                        ;38;0;47;85;0,402472035
69;2;LA PAZ ;20803;TIAWANACU                     ;108;0;80;188;0,587827698
70;2;LA PAZ ;20804;DESAGUADERO                   ;65;0;23;88;0,69023779
71;2;LA PAZ ;20805;SAN ANDRES DE MACHACA         ;3;0;36;39;0,24166156
72;2;LA PAZ ;20806;JESUS DE MACHACA              ;107;0;81;188;0,553930011
73;2;LA PAZ ;20807;TARACO                        ;20;0;13;33;0,19704342
74;2;LA PAZ ;20901;LURIBAY                       ;18;0;65;83;0,445363976
75;2;LA PAZ ;20902;SAPAHAQUI                     ;36;0;44;80;0,234165906
76;2;LA PAZ ;20903;YACO                          ;40;1;58;99;0,517478204
77;2;LA PAZ ;20904;MALLA                         ;2;0;34;36;0,315014245
78;2;LA PAZ ;20905;CAIROMA                       ;89;0;57;146;0,538607835
79;2;LA PAZ ;21001;INQUISIVI                     ;21;0;71;92;0,263768569
80;2;LA PAZ ;21002;QUIME                         ;66;3;35;104;0,728377266
81;2;LA PAZ ;21003;CAJUATA                       ;123;0;11;134;0,990985713
82;2;LA PAZ ;21004;COLQUIRI                      ;118;0;137;255;0,622415003
83;2;LA PAZ ;21005;ICHOCA                        ;3;0;44;47;0,327084088
84;2;LA PAZ ;21006;LICOMA PAMPA                  ;17;0;6;23;0,360912045
85;2;LA PAZ ;21101;CHULUMANI (V. DE LA LIBERTAD) ;261;85;18;364;1,030784669
86;2;LA PAZ ;21102;IRUPANA (VILLA DE LANZA)      ;128;0;57;185;0,788268027
87;2;LA PAZ ;21103;YANACACHI                     ;34;0;7;41;0,46687085
88;2;LA PAZ ;21104;PALOS BLANCOS                 ;364;0;102;466;1,051912674
89;2;LA PAZ ;21105;LA ASUNTA                     ;582;0;137;719;1,288744339
90;2;LA PAZ ;21201;PUCARANI                      ;144;0;209;353;0,525827357
91;2;LA PAZ ;21202;LAJA                          ;93;0;94;187;0,48790386
92;2;LA PAZ ;21203;BATALLAS                      ;69;1;80;150;0,342367603
93;2;LA PAZ ;21204;PUERTO PEREZ                  ;6;0;80;86;0,501483819
94;2;LA PAZ ;21301;SICA SICA (VILLA AROMA)       ;135;0;113;248;0,341754709
95;2;LA PAZ ;21302;UMALA                         ;32;0;81;113;0,442262382
96;2;LA PAZ ;21303;AYO AYO                       ;33;0;54;87;0,551579609
97;2;LA PAZ ;21304;CALAMARCA                     ;95;0;83;178;0,582331454
98;2;LA PAZ ;21305;PATACAMAYA                    ;355;23;65;443;0,84000262
99;2;LA PAZ ;21306;COLQUENCHA                    ;62;0;56;118;0,520153656
100;2;LA PAZ ;21307;COLLANA                       ;10;0;17;27;0,307531523
101;2;LA PAZ ;21401;COROICO                       ;266;104;15;385;1,253342984
102;2;LA PAZ ;21402;CORIPATA                      ;117;0;30;147;0,493049696
103;2;LA PAZ ;21501;IXIAMAS                       ;97;0;38;135;0,843897863
104;2;LA PAZ ;21502;SAN BUENA VENTURA             ;151;11;23;185;1,185565326
105;2;LA PAZ ;21601;GRAL. J.J. PEREZ  (CHARAZANI) ;29;0;87;116;0,601531973
106;2;LA PAZ ;21602;CURVA                         ;1;0;30;31;0,535195871
107;2;LA PAZ ;21701;COPACABANA                    ;98;0;32;130;0,399101606
108;2;LA PAZ ;21702;SAN PEDRO DE TIQUINA          ;28;0;27;55;0,442782493
109;2;LA PAZ ;21703;TITO YUPANQUI (PARQUIPUJIO)   ;2;0;7;9;0,143611648
110;2;LA PAZ ;21801;SAN PEDRO DE CURAHUARA        ;15;0;57;72;0,350121984
111;2;LA PAZ ;21802;PAPEL PAMPA                   ;39;0;37;76;0,550841761
112;2;LA PAZ ;21803;CHACARILLA                    ;4;0;9;13;0,389458655
113;2;LA PAZ ;21901;SANTIAGO DE MACHACA           ;20;0;25;45;0,4915879
114;2;LA PAZ ;21902;CATACORA                      ;2;0;11;13;0,229411873
115;2;LA PAZ ;22001;CARANAVI                      ;800;192;61;1053;0,939187227
116;2;LA PAZ ;22002;ALTO BENI                     ;106;0;17;123;0,583684647
117;3;COCHABAMBA;30101;COCHABAMBA                    ;9621;9767;7;19395;0,97510212
118;3;COCHABAMBA;30201;AIQUILE                       ;266;58;32;356;0,497902449
119;3;COCHABAMBA;30202;PASORAPA                      ;19;0;10;29;0,322444889
120;3;COCHABAMBA;30203;OMEREQUE                      ;48;0;22;70;0,462816967
121;3;COCHABAMBA;30301;AYOPAYA (V. DE INDEPENDENCIA) ;199;22;143;364;0,671175794
122;3;COCHABAMBA;30302;MOROCHATA                     ;68;0;77;145;0,324838857
123;3;COCHABAMBA;30303;COCAPATA                      ;88;0;128;216;0,428133647
124;3;COCHABAMBA;30401;TARATA                        ;100;0;10;110;0,50984919
125;3;COCHABAMBA;30402;ANZALDO                       ;47;0;37;84;0,418630051
126;3;COCHABAMBA;30403;ARBIETO                       ;154;0;51;205;0,79433326
127;3;COCHABAMBA;30404;SACABAMBA                     ;49;0;7;56;0,437327541
128;3;COCHABAMBA;30501;ARANI                         ;112;0;6;118;0,510650903
129;3;COCHABAMBA;30502;VACAS                         ;53;0;60;113;0,300147937
130;3;COCHABAMBA;30601;ARQUE                         ;56;0;136;192;0,598774876
131;3;COCHABAMBA;30602;TACOPAYA                      ;44;0;74;118;0,345648622
132;3;COCHABAMBA;30701;CAPINOTA                      ;208;0;30;238;0,55481774
133;3;COCHABAMBA;30702;SANTIVAÑES                    ;53;0;8;61;0,376458163
134;3;COCHABAMBA;30703;SICAYA                        ;16;0;25;41;0,997896627
135;3;COCHABAMBA;30801;CLIZA                         ;253;151;7;411;0,732936579
136;3;COCHABAMBA;30802;TOCO                          ;42;0;6;48;0,299765079
137;3;COCHABAMBA;30803;TOLATA                        ;45;0;2;47;0,256940123
138;3;COCHABAMBA;30901;QUILLACOLLO                   ;1468;681;91;2240;0,548760075
139;3;COCHABAMBA;30902;SIPE SIPE                     ;483;0;25;508;0,406125915
140;3;COCHABAMBA;30903;TIQUIPAYA                     ;799;254;52;1105;0,4099607
141;3;COCHABAMBA;30904;VINTO                         ;693;145;28;866;0,680675576
142;3;COCHABAMBA;30905;COLCAPIRHUA                   ;341;117;0;458;0,21800141
143;3;COCHABAMBA;31001;SACABA                        ;1791;468;68;2327;0,451443495
144;3;COCHABAMBA;31002;COLOMI                        ;229;0;18;247;0,496000702
145;3;COCHABAMBA;31003;VILLA TUNARI                  ;1238;585;100;1923;1,457132759
146;3;COCHABAMBA;31101;TAPACARI                      ;46;0;284;330;0,422897819
147;3;COCHABAMBA;31201;TOTORA(CBBA)                  ;251;27;6;284;1,051884894
148;3;COCHABAMBA;31202;POJO (CBBA)                   ;164;0;6;170;0,344729058
149;3;COCHABAMBA;31203;POCONA                        ;142;0;17;159;0,47735524
150;3;COCHABAMBA;31204;CHIMORE                       ;150;0;35;185;0,349441718
151;3;COCHABAMBA;31205;PUERTO VILLARROEL             ;1059;281;64;1404;1,100829182
152;3;COCHABAMBA;31206;ENTRE RIOS CBBA               ;319;0;19;338;0,355722249
153;3;COCHABAMBA;31301;MIZQUE                        ;332;31;79;442;0,558685021
154;3;COCHABAMBA;31302;VILA VILA                     ;36;0;40;76;0,682101692
155;3;COCHABAMBA;31303;ALALAY                        ;13;0;16;29;0,206105811
156;3;COCHABAMBA;31401;PUNATA                        ;490;390;2;882;1,365897394
157;3;COCHABAMBA;31402;VILLA RIVERO                  ;63;0;15;78;0,524010249
158;3;COCHABAMBA;31403;SAN BENITO                    ;55;0;10;65;0,193612514
159;3;COCHABAMBA;31404;TACACHI                       ;4;0;3;7;0,083988256
160;3;COCHABAMBA;31405;CUCHUMUELA (V. G. VILLARROEL) ;12;0;3;15;0,328289884
161;3;COCHABAMBA;31501;BOLIVAR                       ;15;0;93;108;0,443678431
162;3;COCHABAMBA;31601;TIRAQUE (CBBA)                ;232;0;37;269;0,50740325
163;3;COCHABAMBA;31602;SHINAOTA                      ;373;62;9;444;1,156331293
164;4;ORURO ;40101;ORURO                         ;4223;3793;73;8089;1,355254345
165;4;ORURO ;40102;CARACOLLO                     ;175;12;54;241;0,356446284
166;4;ORURO ;40103;EL CHORO                      ;29;0;32;61;0,209823659
167;4;ORURO ;40104;SORACACHI                     ;37;0;54;91;0,219789024
168;4;ORURO ;40201;CHALLAPATA                    ;464;87;159;710;1,263651791
169;4;ORURO ;40202;SANTUARIO DE QUILLACAS        ;17;0;31;48;0,535805028
170;4;ORURO ;40301;CORQUE                        ;23;1;47;71;0,352748528
171;4;ORURO ;40302;CHOQUE COTA                   ;1;0;8;9;0,231246967
172;4;ORURO ;40401;CURAHUARA DE CARANGAS         ;58;0;6;64;0,48184849
173;4;ORURO ;40402;TURCO                         ;15;0;17;32;0,41268621
174;4;ORURO ;40501;HUACHACALLA                   ;8;0;2;10;0,206754371
175;4;ORURO ;40502;ESCARA                        ;1;0;1;2;0,061095258
176;4;ORURO ;40503;CRUZ DE MACHACAMARCA;0;0;0;0;0
177;4;ORURO ;40504;YUNGUYO DE LITORAL;0;0;0;0;0
178;4;ORURO ;40505;ESMERALDA                     ;0;0;2;2;0,044369677
179;4;ORURO ;40601;POOPO                         ;40;0;7;47;0,348164995
180;4;ORURO ;40602;PAZÑA                         ;41;0;21;62;0,78453948
181;4;ORURO ;40603;ANTEQUERA                     ;15;0;5;20;0,321369066
182;4;ORURO ;40701;HUANUNI                       ;232;134;14;380;0,890659621
183;4;ORURO ;40702;MACHACAMARCA                  ;34;0;1;35;0,452568317
184;4;ORURO ;40801;SALINAS DE GARCI MENDOZA      ;106;0;51;157;0,63481078
185;4;ORURO ;40802;PAMPA AULLAGAS                ;17;0;31;48;0,482427854
186;4;ORURO ;40901;SABAYA                        ;17;0;15;32;0,141023559
187;4;ORURO ;40902;COIPASA                       ;15;0;0;15;0,70989867
188;4;ORURO ;40903;CHIPAYA                       ;16;0;22;38;0,632919555
189;4;ORURO ;41001;TOLEDO                        ;36;0;24;60;0,250831356
190;4;ORURO ;41101;EUCALIPTUS                    ;43;0;18;61;0,483680094
191;4;ORURO ;41201;ANDAMARCA                     ;7;0;27;34;0,275078391
192;4;ORURO ;41202;BELEN DE ANDAMARCA            ;9;0;10;19;0,480924667
193;4;ORURO ;41301;TOTORA(ORR)                   ;27;0;35;62;0,602260164
194;4;ORURO ;41401;SANTIAGO DE HUARI             ;74;0;27;101;0,454318586
195;4;ORURO ;41501;LA RIVERA                     ;1;0;1;2;0,156230007
196;4;ORURO ;41502;TODOS SANTOS                  ;2;0;0;2;0,216734318
197;4;ORURO ;41503;CARANGAS;0;0;0;0;0
198;4;ORURO ;41601;HUAYLLAMARCA                  ;18;0;17;35;0,312336212
199;5;POTOSI ;50101;POTOSI                        ;4122;1395;35;5552;0,988183414
200;5;POTOSI ;50102;TINGUIPAYA                    ;37;0;224;261;0,250034973
201;5;POTOSI ;50103;YOCALLA                       ;41;0;27;68;0,247700223
202;5;POTOSI ;50104;BELEN DE URMIRI               ;3;0;7;10;0,154974788
203;5;POTOSI ;50201;UNCIA                         ;263;28;96;387;0,670459613
204;5;POTOSI ;50202;CHAYANTA                      ;119;0;111;230;0,482203324
205;5;POTOSI ;50203;LLALLAGUA                     ;630;195;37;862;0,808032237
206;5;POTOSI ;50204;CHUQUIHUTA AYLLU JUCUMANI     ;110;0;19;129;0,648795102
207;5;POTOSI ;50301;BETANZOS                      ;304;16;153;473;0,427408219
208;5;POTOSI ;50302;CHAQUI                        ;58;3;36;97;0,348175302
209;5;POTOSI ;50303;TACOBAMBA                     ;29;0;103;132;0,374560125
210;5;POTOSI ;50401;COLQUECHACA                   ;157;0;339;496;0,472149584
211;5;POTOSI ;50402;RAVELO                        ;61;0;132;193;0,331443311
212;5;POTOSI ;50403;POCOATA                       ;70;0;314;384;0,627542509
213;5;POTOSI ;50404;OCURI                         ;119;1;140;260;0,429426911
214;5;POTOSI ;50501;SAN PEDRO DE BUENA VISTA      ;183;0;210;393;0,430048771
215;5;POTOSI ;50502;TORO TORO                     ;72;0;101;173;0,554452025
216;5;POTOSI ;50601;COTAGAITA                     ;158;0;81;239;0,383531162
217;5;POTOSI ;50602;VITICHI                       ;54;0;46;100;0,387536063
218;5;POTOSI ;50701;SACACA                        ;146;0;97;243;0,385024439
219;5;POTOSI ;50702;CARIPUYO                      ;41;0;107;148;0,542514462
220;5;POTOSI ;50801;TUPIZA                        ;621;148;113;882;0,793782416
221;5;POTOSI ;50802;ATOCHA                        ;134;2;7;143;0,662800422
222;5;POTOSI ;50901;"COLCHA ""K""                    ";46;0;116;162;0,478099444
223;5;POTOSI ;50902;SAN PEDRO DE QUEMES           ;6;0;5;11;0,383005259
224;5;POTOSI ;51001;SAN PABLO DE LIPEZ            ;0;0;34;34;0,440852524
225;5;POTOSI ;51002;MOJINETE                      ;7;0;12;19;0,966405442
226;5;POTOSI ;51003;SAN ANTONIO DE ESMORUCO       ;4;0;35;39;0,57573716
227;5;POTOSI ;51101;PUNA                          ;161;1;79;241;0,360856453
228;5;POTOSI ;51102;"CAIZA ""D""                     ";47;0;28;75;0,29167414
229;5;POTOSI ;51103;CKOCHAS                       ;48;0;178;226;0,461449784
230;5;POTOSI ;51201;UYUNI                         ;532;150;76;758;1,379877881
231;5;POTOSI ;51202;TOMAVE                        ;88;0;90;178;0,449405648
232;5;POTOSI ;51203;PORCO                         ;115;0;37;152;0,826830857
233;5;POTOSI ;51301;ARAMPAMPA                     ;14;0;41;55;1,564211154
234;5;POTOSI ;51302;ACACIO                        ;45;0;39;84;1,977059829
235;5;POTOSI ;51401;LLICA                         ;45;0;12;57;0,196295949
236;5;POTOSI ;51402;TAHUA                         ;6;0;7;13;0,045944948
237;5;POTOSI ;51501;VILLAZON                      ;542;143;15;700;0,527037305
238;5;POTOSI ;51601;SAN AGUSTIN                   ;4;0;20;24;0,371517036
239;6;TARIJA ;60101;TARIJA                        ;3138;2623;11;5772;0,947216154
240;6;TARIJA ;60201;PADCAYA                       ;123;0;49;172;0,346575365
241;6;TARIJA ;60202;BERMEJO                       ;400;258;9;667;0,688380989
242;6;TARIJA ;60301;YACUIBA                       ;1335;936;34;2305;0,628086976
243;6;TARIJA ;60302;CARAPARI                      ;102;0;17;119;0,55524402
244;6;TARIJA ;60303;VILLA MONTES                  ;696;415;17;1128;1,636557443
245;6;TARIJA ;60401;URIONDO (A. CONCEPCION)       ;100;0;8;108;0,367642611
246;6;TARIJA ;60402;YUNCHARA                      ;34;0;41;75;0,59998808
247;6;TARIJA ;60501;SAN LORENZO(TJA)              ;63;0;14;77;0,143267687
248;6;TARIJA ;60502;EL PUENTE(TJA)                ;121;1;31;153;0,660043901
249;6;TARIJA ;60601;ENTRE RIOS  TRJ               ;188;52;42;282;0,710321696
250;7;SANTA CRUZ;70101;SANTA CRUZ DE LA SIERRA       ;16266;22383;11;38660;0,735554561
251;7;SANTA CRUZ;70102;COTOCA                        ;748;193;13;954;0,560355418
252;7;SANTA CRUZ;70103;PORONGO                       ;36;0;5;41;0,109924519
253;7;SANTA CRUZ;70104;LA GUARDIA                    ;710;0;17;727;0,363910391
254;7;SANTA CRUZ;70105;EL TORNO                      ;678;509;5;1192;0,703928253
255;7;SANTA CRUZ;70201;WARNES                        ;1275;218;19;1512;1,12426919
256;7;SANTA CRUZ;70202;OKINAWA                       ;157;0;3;160;0,429761612
257;7;SANTA CRUZ;70301;SAN IGNACIO DE VELASCO        ;891;467;102;1460;1,232688694
258;7;SANTA CRUZ;70302;SAN MIGUEL DE VELASCO         ;162;0;17;179;0,677553107
259;7;SANTA CRUZ;70303;SAN RAFAEL                    ;63;0;5;68;0,402949942
260;7;SANTA CRUZ;70401;BUENA VISTA                   ;98;0;5;103;0,297579546
261;7;SANTA CRUZ;70402;SAN CARLOS                    ;338;127;6;471;0,977639656
262;7;SANTA CRUZ;70403;YAPACANI                      ;639;393;17;1049;1,009370733
263;7;SANTA CRUZ;70404;SAN JUAN DE YAPACANI          ;47;36;2;85;0,318856352
264;7;SANTA CRUZ;70501;SAN JOSE DE CHIQUITOS         ;271;138;6;415;1,146151867
265;7;SANTA CRUZ;70502;PAILON                        ;370;31;8;409;0,337569613
266;7;SANTA CRUZ;70503;ROBORE                        ;220;80;1;301;1,076048132
267;7;SANTA CRUZ;70601;PORTACHUELO                   ;242;314;2;558;1,33644162
268;7;SANTA CRUZ;70602;SANTA ROSA DEL SARA           ;125;0;7;132;0,286386613
269;7;SANTA CRUZ;70603;COLPA BELGICA                 ;35;0;0;35;0,219262413
270;7;SANTA CRUZ;70701;LAGUNILLAS                    ;54;1;14;69;0,496784373
271;7;SANTA CRUZ;70702;CHARAGUA                      ;475;155;48;678;1,013101392
272;7;SANTA CRUZ;70703;CABEZAS                       ;287;0;7;294;0,514357994
273;7;SANTA CRUZ;70704;CUEVO                         ;22;0;5;27;0,333249285
274;7;SANTA CRUZ;70705;GUTIERREZ                     ;132;0;63;195;0,647710966
275;7;SANTA CRUZ;70706;CAMIRI                        ;538;492;5;1035;1,35119733
276;7;SANTA CRUZ;70707;BOYUIBE                       ;33;0;4;37;0,3943856
277;7;SANTA CRUZ;70801;VALLEGRANDE                   ;155;203;1;359;0,886316394
278;7;SANTA CRUZ;70802;TRIGAL                        ;7;0;1;8;0,118233202
279;7;SANTA CRUZ;70803;MORO MORO                     ;18;0;2;20;0,325821285
280;7;SANTA CRUZ;70804;POSTRER VALLE                 ;8;0;2;10;0,146121678
281;7;SANTA CRUZ;70805;PUCARA                        ;4;0;2;6;0,115950953
282;7;SANTA CRUZ;70901;SAMAIPATA                     ;68;35;2;105;0,437830747
283;7;SANTA CRUZ;70902;PAMPA GRANDE                  ;88;0;2;90;0,387188697
284;7;SANTA CRUZ;70903;MAIRANA                       ;133;191;2;326;1,545837919
285;7;SANTA CRUZ;70904;QUIRUSILLAS                   ;5;0;0;5;0,087087146
286;7;SANTA CRUZ;71001;MONTERO                       ;1537;1668;7;3212;1,173645805
287;7;SANTA CRUZ;71002;GENERAL SAAVEDRA              ;126;0;7;133;0,24361229
288;7;SANTA CRUZ;71003;MINEROS                       ;189;0;25;214;0,359764806
289;7;SANTA CRUZ;71004;FERNANDEZ ALONSO              ;115;0;9;124;0,36408817
290;7;SANTA CRUZ;71005;SAN PEDRO                     ;125;2;9;136;0,30985398
291;7;SANTA CRUZ;71101;CONCEPCION                    ;308;0;43;351;0,765261894
292;7;SANTA CRUZ;71102;SAN JAVIER(STC)               ;299;63;3;365;1,014456854
293;7;SANTA CRUZ;71103;SAN RAMON SCZ                 ;168;12;0;180;0,976751593
294;7;SANTA CRUZ;71104;SAN JULIAN                    ;746;178;11;935;0,780543992
295;7;SANTA CRUZ;71105;SAN ANTONIO DE LOMERIO        ;64;0;35;99;0,494299389
296;7;SANTA CRUZ;71106;CUATRO CAÑADAS                ;230;0;6;236;0,426303815
297;7;SANTA CRUZ;71201;SAN MATIAS                    ;178;77;14;269;0,775159093
298;7;SANTA CRUZ;71301;COMARAPA                      ;207;113;7;327;0,832603124
299;7;SANTA CRUZ;71302;SAIPINA                       ;52;0;2;54;0,370620344
300;7;SANTA CRUZ;71401;PUERTO SUAREZ                 ;287;221;3;511;1,216593403
301;7;SANTA CRUZ;71402;PUERTO QUIJARRO               ;246;68;6;320;0,615154351
302;7;SANTA CRUZ;71403;CARMEN RIVERO TORREZ          ;71;0;1;72;0,532713553
303;7;SANTA CRUZ;71501;ASCENCION DE GUARAYOS         ;523;268;41;832;1,6360185
304;7;SANTA CRUZ;71502;URUBICHA                      ;99;0;4;103;0,670645183
305;7;SANTA CRUZ;71503;EL PUENTE(STC)                ;105;0;13;118;0,47355114
306;8;BENI ;80101;TRINIDAD                      ;2153;1816;4;3973;1,156087483
307;8;BENI ;80102;SAN JAVIER(BNI)               ;30;0;4;34;0,361000626
308;8;BENI ;80201;RIBERALTA                     ;2408;1019;25;3452;1,09844871
309;8;BENI ;80202;GUAYARAMERIN                  ;782;575;12;1369;0,927813282
310;8;BENI ;80301;REYES                         ;162;66;56;284;0,581167514
311;8;BENI ;80302;SAN BORJA                     ;600;323;100;1023;0,739141407
312;8;BENI ;80303;SANTA ROSA                    ;160;19;26;205;0,661830829
313;8;BENI ;80304;RURRENABAQUE                  ;360;200;18;578;1,033622023
314;8;BENI ;80401;SANTA ANA                     ;279;186;25;490;1,021194883
315;8;BENI ;80402;EXALTACION                    ;16;0;6;22;0,062266237
316;8;BENI ;80501;SAN IGNACIO                   ;330;73;68;471;0,735859021
317;8;BENI ;80601;LORETO                        ;20;0;6;26;0,295472674
318;8;BENI ;80602;SAN ANDRES                    ;71;0;14;85;0,27631232
319;8;BENI ;80701;SAN JOAQUIN                   ;51;48;1;100;0,512307583
320;8;BENI ;80702;SAN RAMON BENI                ;65;36;0;101;0,527848625
321;8;BENI ;80703;PUERTO SILES                  ;4;0;4;8;0,284201259
322;8;BENI ;80801;MAGDALENA                     ;197;50;37;284;0,905725623
323;8;BENI ;80802;BAURES                        ;66;20;4;90;0,686968385
324;8;BENI ;80803;HUARACAJE                     ;45;17;0;62;0,651718043
325;9;PANDO ;90101;COBIJA                        ;903;763;1;1667;1,084432859
326;9;PANDO ;90102;PORVENIR                      ;50;0;8;58;0,389736604
327;9;PANDO ;90103;BOLPEBRA                      ;3;0;0;3;0,067758647
328;9;PANDO ;90104;BELLA FLOR                    ;12;0;7;19;0,287712059
329;9;PANDO ;90201;PUERTO RICO                   ;122;0;19;141;0,985987055
330;9;PANDO ;90202;SAN PEDRO(PND)                ;0;0;7;7;0,270287596
331;9;PANDO ;90203;FILADELFIA                    ;23;0;34;57;0,487467909
332;9;PANDO ;90301;PUERTO GONZALO MORENO         ;50;0;22;72;0,43844411
333;9;PANDO ;90302;SAN LORENZO(PND)              ;38;0;22;60;0,513089064
334;9;PANDO ;90303;SENA                          ;88;0;15;103;1,551402623
335;9;PANDO ;90401;NACEBE (SANTA ROSA DEL ABUNA) ;25;0;14;39;0,457691705
336;9;PANDO ;90402;INGAVI (HUMAITA)              ;8;0;7;15;0,703385338
337;9;PANDO ;90501;NUEVO MANOA (NUEVA ESPERANZA) ;3;0;4;7;0,181752179
338;9;PANDO ;90502;VILLA NUEVA (LOMA ALTA)       ;0;0;9;9;0,231122419
339;9;PANDO ;90503;EUREKA (SANTOS MERCADO)       ;4;0;18;22;1,10898069
